111111111111111
10010000000C111
100001101100111
1P001CE00000111
111111111111111