1111111111
1100001111
100000C111
10P0000E11
1111111111