1111111111
1C0P000C01
1100E00001
1110000001
1010011111
1111111111
